XXXXXXXXXXXXXXXXX
X       X       X
X       X       X
X       X       X
X       X       X
X       X       X
X       X       X
X       X       X
X       X       X
X       X       X
X       W       X
X       X       X
X       X       X
X       X       X
XXXXXXXXXXXXXXXXX
